R 1000 1000
NO ./path_to_the_north_texture
SO ./path_to_the_south_texture
WE ./path_to_the_west_texture
EA ./path_to_the_east_texture

S ./path_to_the_sprite_texture
F 0,151,57
C 0,191,255

11111111111
10000000001
100000N0001
10000000001
11111111111
