R    1280  800
NO ./resources/textures/wall_grass-3.xpm
WE ./resources/textures/paporotnik-2.xpm
SO           ./resources/textures/wall_grass-1.xpm
EA ./resources/textures/paporotnik-1.xpm
S ./resources/textures/clicker-4.xpm
F 25,90,0
C 54, 186, 223

                                        111111
                                        11020111111111
11111111111111111                       11000000000001
100000000000000011111111111111111111111111020020020021
102000002000002000000000000000000000000000000000000001
100003000000000011111111111111111001111111111111011111
10002000200030001               1001           101
10000000000000001               1001           101111111111111111
10202020002030201               1001           100000000000000001
10000000000000001           111110011111       111111111111111101
10003000200200001           100000000001                      101
10000000000000001           100000000001                      101
10200000200002001111111111111000200200011111111111111111111111101
1000000000000000000000000000000000000000000000W000000000000000001
11111111111111111111111111111111111111111111111111111111111111111