R    1280  800
NO ./resources/textures/wall_grass-3.xpm
WE ./resources/textures/paporotnik-2.xpm
SO           ./resources/textures/wall_grass-1.xpm
EA ./resources/textures/paporotnik-1.xpm
S ./resources/textures/clicker-triple.xpm
F 0,151,57
C 0,191  ,  255

111111111111
100S0001
10000001
10000001
10000001
10000001
10000001
10000001
10000001
10000001
10000001
10000001
10111101
10200001
10020001
10002001
10020201
10000001
111111111111111111111111111111111