R 1280 800
NO ./Render/textures/paporotnik-1.xpm
WE ./Render/textures/paporotnik-2.xpm
SO           ./Render/textures/wall_grass-3.xpm
EA ./Render/textures/wall_grass-1.xpm
S ./Render/textures/clicker.xpm
F 0,151,57
C 0,191  ,  255

1111111
1002001
10000N1
1111111