R 1000 1000
NO ./path_to_the_north_texture
SO ./path_to_the_south_texture
WE ./path_to_the_west_texture
EA ./path_to_the_east_texture

S ./path_to_the_sprite_texture
F 0,151,57
C 0,191,255

111111111
110000011
100000001
100000001
100000001
100000001
100W00001
100000001
100000001
100000001
100000001
100000001
110000011
111111111
