R    1280  800
NO ./Render/textures/paporotnik-3.xpm
WE ./Render/textures/paporotnik-2.xpm
SO           ./Render/textures/wall_grass-3.xpm
EA ./Render/textures/wall_grass-1.xpm
S ./Render/textures/clicker.xpm
F 0,151,57
C 0,191  ,  255

111111111111
100S0001
10000001
10000001
10000001
10000001
10000001
10000001
10000001
10000001
10000001
10000001
10000001
10000001
10000001
10000001
10020001
10000001
111111111111111111111111111111111