R 1280 800
NO ./Render/textures/north.xpm
SO ./Render/textures/south.xpm
WE ./Render/textures/west.xpm
EA ./Render/textures/east.xpm
S ./Render/textures/butters.xpm
F 0,151,57
C 0,191,255

        1111111111111111111111111
        1000000000110000000000001
        1011000001110000000200001
        1001000000000000000000001
111111111011000001110000000000001
100000200011000001110111010111111
11110111111111011000000010001
11110111111111011101010010201
11000000110101011100000010001
10000200000000001100000010001
10000000000000001101010012221
11000001110101011111011112W2111
11110111 1110101 101111012221
11111111 1111111 11111111111