R    1280  800
NO ./Render/textures/paporotnik-3.xpm
WE ./Render/textures/paporotnik-2.xpm
SO           ./Render/textures/wall_grass-3.xpm
EA ./Render/textures/wall_grass-1.xpm
S ./Render/textures/clicker.xpm
F 0,151,57
C 0,191  ,  255

        1111111111111111111111111
111     1000000000110000000000001
101     1011000001110000000200001
111     1001000000000000000000W01
111111111011000001110000000000001
100000000011000001110111010111111
11110111111111011000000010001
11110111111111011101010010201
11000000110101011100000010001
10000000000000001100000010001
10000000000000001101010010001
1100000111010101111101111000111
11110111 1110101 101111010001
11111111 1111111 11111111111