R 1280 800
NO ./Render/textures/north.xpm
SO ./Render/textures/south.xpm
WE ./Render/textures/west.xpm
EA ./Render/textures/east.xpm
S ./Render/textures/barrel.xpm
F 0,151,57
C 0,191,  255

111111
100001
100N21
100001
11111111111