R      1280 800
NO ./resources/textures/wall_grass-3.xpm
WE ./resources/textures/paporotnik-2.xpm
SO           ./resources/textures/wall_grass-1.xpm
EA ./resources/textures/paporotnik-1.xpm
S ./resources/textures/clicker.xpm
F 25,90,00
C 54, 186, 223

111111
1000N1
111111