R 1000 1000
NO ./Render/textures/north.xpm
SO ./Render/textures/south.xpm
WE ./Render/textures/west.xpm
EA ./Render/textures/nastya.xpm
S ./Render/textures/tank.xpm
F 0,151,57
C 0,191,255

        1111111111111111111111111
        1000000000110000000000001
        1011000001110000002000001
        1001000000000000020200001
111111111011000001110000000000001
100000000011000001110111110111111
11110111111111011100000010001
11110111111111011101010010001
11000000110101011100000010001
10002000000000001100000010001
10000000000000001101010010001
11000001110101011111011110E2111
11110111 1110101 101111010001
11111111 1111111 11111111111