R    800  600
NO ./resources/textures/wall_grass-3.xpm
WE ./resources/textures/paporotnik-2.xpm
SO           ./resources/textures/wall_grass-1.xpm
EA ./resources/textures/paporotnik-1.xpm
S ./resources/textures/clicker-4.xpm
F 25,90,0
C 54, 186, 223

                                        111111
                                        11020111111111
11111111111111111                       11000000000001
100000000000000011111111111111111111111111030030020031
102000003000603000000000000000000000000000000000000001
100003000000000011111111111111111001111111111111411111
10003000200030001               1001           101
10000000000000001               1001           101111111111111111
10203020002030201               1001           100000000000000001
10000000000000001           111110011111       111111111111111101
10003000200200001           100000000001                      101
10000000000000001           100000000001                      101
10300000300002001111111111111000200200011111111111111111111111101
10000000000000000000000000000000000000000000000000000000000000001
11111114111111111111111111111111114111111114111411111111111141111
1000000000000000000000000000300000000000000000W000000000000000001
10000000000000300000000000000000000000003000000000000000000000001
11111111111111111111111111111111111111111111111111111111111111111